András Kovács - andraskovacs@gmail.com
Péter Nagy - peternagy@gmail.com
Gábor Tóth - gabortoth@gmail.com
János Szabó - janosszabo@gmail.com
István Horváth - istvanhorvath@gmail.com
Zoltán Kiss - zoltankiss@gmail.com
László Lakatos - laszlolakatos@gmail.com
Ferenc Farkas - ferencfarkas@gmail.com
Máté Balogh - matebalogh@gmail.com
Tamás Molnár - tamasmolnar@gmail.com

Dávid Papp - davidpapp@gmail.com
Sándor Varga - sandorvarga@gmail.com
Balázs Simon - balazssimon@gmail.com
Attila Hegedűs - attilahegedus@gmail.com
Krisztián Takács - krisztiantakacs@gmail.com
Ádám Bíró - adambiro@gmail.com
Benedek Mészáros - benedekmeszaros@gmail.com
Dániel Fehér - danielfeher@gmail.com
Gergő Török - gergotorok@gmail.com
Viktor Szűcs - viktorszucs@gmail.com

Zsolt Kocsis - zsoltkocsis@gmail.com
Márton Tóth - martontoth@gmail.com
Csaba Sándor - csabasandor@gmail.com
Milán Kővári - milankovari@gmail.com
Norbert Kovács - norbertkovacs@gmail.com
Roland Pataki - rolandpataki@gmail.com
Kristóf Balázs - kristofbalazs@gmail.com
Levente Fekete - leventefekete@gmail.com
Dániel Orbán - danielorban@gmail.com
Marcell Kocsis - marcellkocsis@gmail.com
Olivér Csonka - olivercsonka@gmail.com
Bence Farkas - bencefarkas@gmail.com

Levente Török - leventetorok@gmail.com
Botond Molnár - botondmolnar@gmail.com
Márk Lakatos - marklakatos@gmail.com
Barnabás Kovács - barnabaskovacs@gmail.com
Áron Barta - aronbarta@gmail.com
Barnabás Nagy - barnabasnagy@gmail.com
Csongor Kertész - csongorkertesz@gmail.com
Levente Balogh - leventebalogh@gmail.com
Martin Kovács - martinkovacs@gmail.com
Zsombor Fekete - zsomborfekete@gmail.com
Noel Kovács - noelkovacs@gmail.com
Patrik Tóth - patriktoth@gmail.com

Bendegúz Fehér - bendeguzfeher@gmail.com
Dániel Takács - danieltakacs@gmail.com
Márton Varga - martonvarga@gmail.com
Ákos Kovács - akoskovacs@gmail.com
László Horváth - laszlohorvath@gmail.com
Máté Szabó - mateszabo@gmail.com
Zsombor Simon - zsomborsimon@gmail.com
Ádám Hegedűs - adamhegedus@gmail.com
Márk Bíró - markbiro@gmail.com
Noel Farkas - noelfarkas@gmail.com
Dominik Török - dominiktorok@gmail.com
Kristóf Szabó - kristofszabo@gmail.com
Balázs Kovács - balazskovacs@gmail.com
Noel Papp - noelpapp@gmail.com
Dániel Varga - danielvarga@gmail.com
András Szabó - andrasszabo@gmail.com
Csaba Olasz - csabaolasz@gmail.com
Ervin Németh - ervinnemeth@gmail.com